111111111111
1001000000C1
100001111101
100001111101
100001111101
1P0011E00001
100001111101
100001111101
100001111101
100001111101
100001111101
111111111111
