11111
1P001
10E01
100C1
11111
