1111111111111111111111111111111111
1E0000000000C000000000000000000001
1010010100100000101001000000010101
1C1001C010101010P01001000000010101
100000000000000000000000C000000001
1111111111111111111111111111111111