1111111111111111111111111111111111111111
100000E0000000000C000000111000C0P0111111
1111000111111111111100011111111001111111
1111111110000000001111000000000001111111
1111000000000000111111011111111111111111
1111111111111111111111011111001111011111
1100000000000000000000000011111111011111
1111111111111111111111111011111111011111
1000000000000000111111111000000000000001
1111111100001110000000011111111111011111
1110000001111110111111011111111111011111
111101111C0000001110000000000000110000C1
1111011111111111111011111111111000000001
11110000000000000000111111C0000000000001
1111111111111111111111111111111111111111
