1111111111111111
111111110P011111
1111100000011111
1100C0011E01s111
1111111111111111
